+----------+-------+----------+------------+
| campus   | room  | semester | SUM(hours) |
+----------+-------+----------+------------+
| WESTWING | A     | 1        |         36 |
| WESTWING | A     | 2        |         29 |
| WESTWING | NRR   | 2        |          2 |
| WESTWING | V     | 1        |          6 |
| WESTWING | V     | 2        |         26 |
| NRR      | NRR   | 1        |          4 |
| NRR      | NRR   | 2        |         10 |
| STB      | A     | 1        |         94 |
| STB      | A     | 2        |         85 |
| STB      | XY45A | 1        |         11 |
| STB      | XY45A | 2        |         11 |
| STB      | XY47  | 1        |         12 |
| STB      | XY47  | 2        |         12 |
| STB      | XY50  | 1        |         16 |
| STB      | CISCO | 1        |         22 |
| STB      | CISCO | 2        |         35 |
| STB      | NRR   | 1        |          2 |
| STB      | NRR   | 2        |          2 |
| STB      | V     | 1        |         62 |
| STB      | V     | 2        |         84 |
| EASTERN  | A     | 1        |          2 |
| EASTERN  | A     | ALL      |          8 |
| EASTERN  | A3.12 | 1        |         13 |
| EASTERN  | A3.12 | 2        |         14 |
+----------+-------+----------+------------+
