+----------+-------+----------+------------+
| campus   | room  | semester | SUM(hours) |
+----------+-------+----------+------------+
| HALBEATH | ANY   | 1        |         73 |
| HALBEATH | ANY   | 2        |         71 |
| STB      | ANY   | 1        |        119 |
| STB      | ANY   | 2        |        111 |
| STB      | BF19A | 2        |          4 |
+----------+-------+----------+------------+
