+----------+-------+----------+------------+
| campus   | room  | semester | SUM(hours) |
+----------+-------+----------+------------+
| HALBEATH | A     | 1        |         35 |
| HALBEATH | A     | 2        |         15 |
| HALBEATH | NRR   | 2        |          2 |
| HALBEATH | V     | 1        |          6 |
| HALBEATH | V     | 2        |         18 |
| NRR      | NRR   | 1        |          4 |
| NRR      | NRR   | 2        |         10 |
| STB      | A     | 1        |         91 |
| STB      | A     | 2        |         84 |
| STB      | BF45A | 1        |         11 |
| STB      | BF45A | 2        |         11 |
| STB      | BF47  | 1        |         12 |
| STB      | BF47  | 2        |         12 |
| STB      | BS50  | 1        |         16 |
| STB      | CISCO | 1        |         21 |
| STB      | CISCO | 2        |         35 |
| STB      | NRR   | 1        |          2 |
| STB      | NRR   | 2        |          2 |
| STB      | V     | 1        |         42 |
| STB      | V     | 2        |         57 |
| STENTON  | A     | ALL      |          8 |
| STENTON  | S3.12 | 1        |         15 |
| STENTON  | S3.12 | 2        |         14 |
+----------+-------+----------+------------+
