+---------+-----------+----------+------------+
| campus  | room      | semester | SUM(hours) |
+---------+-----------+----------+------------+
| LEVEN   | ANY       | 1        |         35 |
| LEVEN   | ANY       | 2        |         36 |
| LEVEN   | L2.28     | 1        |         20 |
| LEVEN   | L2.28     | 2        |         22 |
| LEVEN   | LCOMP     | 1        |          2 |
| LEVEN   | LCOMP     | 2        |          1 |
| LEVEN   | LDUMMY1   | 1        |          5 |
| LEVEN   | LDUMMY1   | 2        |          3 |
| STB     | ANY       | 1        |        103 |
| STB     | ANY       | 2        |        101 |
| STB     | BCOMP     | 1        |          6 |
| STB     | BCOMP     | 2        |          9 |
| STB     | BDUMMY1   | 2        |          3 |
| STB     | BF16      | 1        |          4 |
| STB     | BF16      | 2        |          4 |
| STB     | BG26      | 1        |          4 |
| STB     | BG26      | 2        |          4 |
| STB     | BS01      | 1        |         21 |
| STB     | BS01      | 2        |         17 |
| STB     | BS45      | 1        |         12 |
| STB     | BS45      | 2        |          9 |
| STENTON | ANY       | 1        |          2 |
| STENTON | S2.11     | 1        |          2 |
| STENTON | S3.6      | 1        |         17 |
| STENTON | S3.6      | 2        |         22 |
| STENTON | SCOMP     | 1        |          2 |
| STENTON | SCOMP     | 2        |          2 |
| STENTON | SDUMMY1   | 1        |          2 |
| STENTON | V2.4+V2.3 | 1        |         15 |
| STENTON | V2.4+V2.3 | 2        |          6 |
| STENTON | V2.5      | 1        |         13 |
| STENTON | V2.5      | 2        |         28 |
| WADE    | WDUMMY    | 1        |         12 |
| WADE    | WDUMMY    | 2        |         12 |
+---------+-----------+----------+------------+
