+---------+-----------+----------+------------+
| campus  | room      | semester | SUM(hours) |
+---------+-----------+----------+------------+
| LEVEN   | ANY       | 1        |         33 |
| LEVEN   | ANY       | 2        |         36 |
| LEVEN   | L2.28     | 1        |         19 |
| LEVEN   | L2.28     | 2        |         23 |
| LEVEN   | LCOMP     | 1        |          3 |
| LEVEN   | LCOMP     | 2        |          3 |
| LEVEN   | LDUMMY1   | 1        |          7 |
| LEVEN   | LDUMMY1   | 2        |          3 |
| STB     | ANY       | 1        |         90 |
| STB     | ANY       | 2        |         80 |
| STB     | BCOMP     | 1        |         11 |
| STB     | BCOMP     | 2        |         16 |
| STB     | BDUMMY1   | 2        |          3 |
| STB     | BF16      | 1        |          6 |
| STB     | BF16      | 2        |         12 |
| STB     | BG26      | 1        |          4 |
| STB     | BG26      | 2        |          4 |
| STB     | BS01      | 1        |         25 |
| STB     | BS01      | 2        |         15 |
| STB     | BS45      | 1        |         19 |
| STB     | BS45      | 2        |         19 |
| STENTON | ANY       | 1        |          2 |
| STENTON | S2.11     | 1        |          2 |
| STENTON | S3.6      | 1        |         27 |
| STENTON | S3.6      | 2        |         21 |
| STENTON | SCOMP     | 1        |          2 |
| STENTON | SCOMP     | 2        |          2 |
| STENTON | SDUMMY1   | 1        |          2 |
| STENTON | V2.4+V2.3 | 1        |         12 |
| STENTON | V2.4+V2.3 | 2        |          7 |
| STENTON | V2.5      | 1        |         18 |
| STENTON | V2.5      | 2        |         28 |
+---------+-----------+----------+------------+
