+----------+-------+----------+------------+
| campus   | room  | semester | SUM(hours) |
+----------+-------+----------+------------+
| HALBEATH | A     |        1 |         58 |
| HALBEATH | A     |        2 |         36 |
| HALBEATH | V     |        1 |          8 |
| HALBEATH | V     |        2 |         24 |
| LEVEN    | L1    |        2 |         19 |
| STB      | A     |        1 |         95 |
| STB      | A     |        2 |         92 |
| STB      | BF45A |        1 |         12 |
| STB      | BF45A |        2 |         12 |
| STB      | BF47  |        1 |         16 |
| STB      | BF47  |        2 |         14 |
| STB      | BS50  |        1 |         19 |
| STB      | BS50  |        2 |          8 |
| STB      | CISCO |        1 |         20 |
| STB      | CISCO |        2 |         32 |
| STB      | V     |        1 |         40 |
| STB      | V     |        2 |         59 |
| STENTON  | A     |        1 |          2 |
| STENTON  | A     |        2 |          2 |
| STENTON  | S3.12 |        1 |         14 |
| STENTON  | S3.12 |        2 |         13 |
+----------+-------+----------+------------+
