+---------+------+----------+------------+
| campus  | room | semester | SUM(hours) |
+---------+------+----------+------------+
| STB     | ANY  |        1 |        480 |
| STENTON | ANY  |        1 |        124 |
+---------+------+----------+------------+
