+----------+------+----------+------------+
| campus   | room | semester | SUM(hours) |
+----------+------+----------+------------+
| HALBEATH | ANY  |        1 |        333 |
| STB      | ANY  |        1 |         98 |
| STENTON  | ANY  |        1 |        782 |
+----------+------+----------+------------+
